1111111111
1   2    1
1   131251
1        1
1   111  1
1   3 5  1
1   121  1
1        1
1   3    1
1111111111
