1111111111
1     1  1
1     3  1
1     1  1
12345 2421
1   1    1
1   3    1
114125 2 1
1      1 1
1111111111
