1111111111
1     1  1
1     2  1
1     1  1
12345 2  1
1        1
1 11 222 1
1 41     1
1        1
1111111111
